102	13	32	12	11	124
1 1 1 1 1 1 1 1 1 1 1 1 3 4 4 4 4 4 4 4 4 4 4 4 4 4 4 4 4 4 4 4 
1 1 1 1 1 1 1 1 1 1 1 1 3 4 4 4 4 4 4 4 4 4 4 4 4 4 4 4 4 4 4 4 
1 1 1 1 1 1 1 1 1 1 1 1 3 4 4 4 4 4 4 4 4 4 4 4 4 4 4 4 4 4 4 4 
1 1 1 25 26 27 1 1 1 1 1 1 3 4 4 4 4 4 4 4 4 4 4 4 4 4 4 4 4 4 4 4 
1 1 1 28 29 30 1 1 1 1 1 1 3 4 4 4 4 4 4 4 4 4 4 4 4 4 4 4 4 4 4 4 
1 1 1 1 1 1 1 1 1 1 1 1 3 4 4 4 4 4 4 4 4 4 4 4 4 4 4 4 4 4 4 4 
1 1 1 1 1 1 1 1 1 1 1 1 3 4 4 4 4 4 57 58 4 4 4 59 60 61 4 4 4 4 4 4 
1 1 1 1 1 1 1 1 1 1 1 1 3 4 4 4 4 4 71 72 4 4 4 73 4 75 4 4 4 4 4 4 
1 1 1 1 1 1 1 1 1 1 1 1 3 4 4 4 4 4 71 57 58 4 4 89 90 91 4 4 4 4 4 4 
1 1 1 1 38 39 1 1 1 1 1 1 3 4 4 4 4 4 71 4 72 4 4 4 4 4 4 4 4 57 58 4 
1 1 1 1 47 48 39 1 8 9 1 1 3 4 4 4 4 4 71 4 57 58 4 4 4 4 4 4 4 71 72 4 
1 103 103 106 107 104 56 1 11 12 1 1 3 4 4 4 4 57 58 4 4 72 4 4 4 4 4 4 57 58 72 4 
117 118 118 118 118 118 118 118 118 118 118 118 118 118 118 118 118 118 118 118 118 118 118 118 118 118 118 118 118 118 118 119
